wwwwwwwwwww
w------f--w
w---f-----w
w---------w
w---------w
w---------w
w---f-----w
w-----f---w
w--------fw
wwwwwwwwwww