wwwwwwwwwwwwwwwwwww
w--------------f--w
w---f-------------w
w-----------------w
w-----------f-----w
w-----------------w
w---f-------------w
w-------------f---w
w----------------fw
wwwwwwwwwwwwwwwwwww